
$$$ exec p2 : [players/abanlin.filler]
<got (X): [0, 11]

Plateau 24 40:
    0123456789012345678901234567890123456789
000 ...X......................X.............
001 ...XXXXXX.................X......X...X..
002 XXXXXXXXXXXX.....X.....XXXXX...XXXX.XX..
003 .XXOXXXXXXXX.XXxxXXXXXXXXXXXXXXXXXXXXXXX
004 XXXOXOOXXXXXXXXXXXXXXXXXXXXXXXXXXXXXXXXX
005 XXXOOOOXOOOXXXXXXXXXXXXXXXXXXXXXXXXXXXXX
006 XXXXXXOOOOXXXXXXXXXXXXXXXXXXXXXXXXXXXXXX
007 XXXXXXXXXOOXXXXXXXXXXXXXXXXXXXXXXXXXXXXX
008 XXXXXXXXXXOXXXXXXXXXXXXXXXXXXXXXXXXXXXXX
009 XXXXXXXXXXOOOOOXXXXXXXXXXXXXXXXXXXXXXXXX
010 XXXXXXXXXOOOOOOOOXXXXXXXXXXXXXXXXXXXXXXX
011 XXXXXXXXXXOOOOOOOOOXXXXXXXXXXXXXXXXXXXXX
012 XXXXXXXXXOOOOOOOOOOXXXXXXXXXXXXXXXXXXXXX
013 XXXXXXXXXXOOOOOOOOOXXXXXXXXXXXXXXXXXXXXX
014 XXXXXXXXXXOOOOOOOOOXXXXXXXXXXXXXXXXXXXXX
015 XXXXXXXXXOOOOOOOOOOXXXXXXXXXXXXXXXXXXXXX
016 XXXXXXXXXOOOOOOOOOOOOOOXXXXXXXXXXXXXXXXX
017 XXXXXXXXOOOOOOOOOOOOOOXXXXXXXXXXXXXXXXXX
018 XXXXXXXXXOOOOOOOOOOOOOOOXXXXXXXXXXXXXXXX
019 XXXXXXXXOOOOOOOOOOOOOOOOXOOOXXXXXXXXXXXX
020 XXXXXXXXOOOOOOOOOOOOOOOOOOOXXXXXXXXXXXXX
021 XXXXXOOOOOOOOOOOOOOOOOOOOOOOXXXXXXXXXXXX
022 XXXXXXOOO.OOOOOOOOOOOOOOOOOXXXXXXXXXXXXX
023 XXXXXXOOOOOOOOOOOOOOOOOOOOOOOOXXXXXXXXXX
Piece 2 4:
.***
....
